{
  "Tiles" : [
    ".......B.......",
    "...............",
    ".....z###z.1...",
    "....#.....#....",
    "x..Y.4...1.X...",
    "x.#...###...#.A",
    "x.#...###...#.A",
    "x..Z.2...2.Z...",
    "....#.....#....",
    ".....X###Y.4...",
    "...............",
    ".......C......."
  ],
  "Player" : {
    "X" : 0,
    "Y" : 5
  },
  "Color1" : "806000",
  "Color2" : "C07818"
}  
