{
  "Tiles" : [
    ".......C.......",
    "...............",
    ".....z###z.1...",
    "....#.....#....",
    "x..Y.4...1.X...",
    "x.#...###...#.A",
    "x.#...###...#.A",
    "x..Z.2...2.Z...",
    "....#.....#....",
    ".....X###Y.4...",
    "...............",
    ".......B......."
  ],
  "Player" : {
    "X" : 0,
    "Y" : 5
  }
}  
